1111111111111111111111111111111111
1000000000000000C00000C00000000000
1011110100100000101001000000010101
1011110010101010001001000000010101
1P0000000C00C000000000001C10000001
1011110100100000101001000000010101
1011110010101010001001000000010101
1011110100100000101001000000010101
1011110010101010001001000000010101
1011110100100000101001000000010101
10111100101010100010010000000101E1
1111111111111111111111111111111111
